begin	KEYWORD2
buildResponse	KEYWORD2
buildResponse16	KEYWORD2
buildResponse32	KEYWORD2
buildResponse8	KEYWORD2
buildResponseBuffer	KEYWORD2
buildResponseEnumDescriptor16	KEYWORD2
buildResponseEnumDescriptor32	KEYWORD2
buildResponseEnumDescriptor8	KEYWORD2
buildResponseFloat	KEYWORD2
buildResponseIfAlreadyPossible	KEYWORD2
CommandClose	LITERAL1
CommandOff	LITERAL1
CommandOn	LITERAL1
CommandOnOff	LITERAL1
CommandOpen	LITERAL1
CommandStop	LITERAL1
countof	LITERAL1
currentClientIP	KEYWORD2
currentClientPort	KEYWORD2
dataType	KEYWORD2
DataTypeFloat32	LITERAL1
DataTypeFloat64	LITERAL1
DataTypeS16	LITERAL1
DataTypeS32	LITERAL1
DataTypeS64	LITERAL1
DataTypeS8	LITERAL1
DataTypeU16	LITERAL1
DataTypeU32	LITERAL1
DataTypeU64	LITERAL1
DataTypeU8	LITERAL1
elementCount	KEYWORD2
exponent	KEYWORD2
IECExbi	LITERAL1
IECGibi	LITERAL1
IECKibi	LITERAL1
IECMebi	LITERAL1
IECPebi	LITERAL1
IECTebi	LITERAL1
IECYobi	LITERAL1
IECZebi	LITERAL1
interfaceCommand	KEYWORD2
interfaceIndex	KEYWORD2
IoTCategoryUuid	LITERAL1
IoTClientCount	LITERAL1
IoTEnumDescriptor16	KEYWORD1
IoTEnumDescriptor32	KEYWORD1
IoTEnumDescriptor8	KEYWORD1
IoTInterface	KEYWORD1
IoTInterfaceCount	LITERAL1
IoTInterfaceDescriptor	KEYWORD1
IoTInterfaceOnOff	KEYWORD1
IoTInterfaceOnOffSimple	KEYWORD1
IoTInterfaceOpenClose	KEYWORD1
IoTInterfaceOpenCloseStop	KEYWORD1
IoTInterfaceSensor	KEYWORD1
IoTMaxPasswordLength	LITERAL1
IoTMaxPayloadLength	LITERAL1
IoTMessageDescribeEnum	KEYWORD1
IoTMessageExecute	KEYWORD1
IoTMessageGetProperty	KEYWORD1
IoTMessageSetProperty	KEYWORD1
IoTNoPassword	LITERAL1
IoTNameUTF8	LITERAL1
IoTPasswordReadOnly	LITERAL1
IoTPort	LITERAL1
IoTProperty	KEYWORD1
IoTPropertyDescriptor	KEYWORD1
IoTResetSupported	LITERAL1
IoTServer	KEYWORD1
IoTUuid	LITERAL1
isBigEndian	KEYWORD2
isMessageRepeated	KEYWORD2
message	KEYWORD2
MessageChangePassword	LITERAL1
MessageDescribeInterface	LITERAL1
MessageDescribeEnum	LITERAL1
MessageExecute	LITERAL1
MessageGetProperty	LITERAL1
MessageGoodBye	LITERAL1
MessageHandshake	LITERAL1
MessageMax	LITERAL1
MessagePing	LITERAL1
MessageQueryDevice	LITERAL1
MessageReset	LITERAL1
MessageSetProperty	LITERAL1
mode	KEYWORD2
ModeReadOnly	LITERAL1
ModeReadWrite	LITERAL1
ModeWriteOnly	LITERAL1
name	KEYWORD2
payloadBuffer	KEYWORD2
payloadLength	KEYWORD2
process	KEYWORD2
PropertyColor	LITERAL1
propertyCount	KEYWORD2
propertyDescriptors	KEYWORD2
propertyIndex	KEYWORD2
PropertyState	LITERAL1
PropertyValue	LITERAL1
propertyValue	KEYWORD2
responseBuffer	KEYWORD2	
ResponseCannotChangePasswordNow	LITERAL1
ResponseDeviceError	LITERAL1
ResponseEndOfPacketNotFound	LITERAL1
ResponseInterfacePropertyReadOnly	LITERAL1
ResponseInterfacePropertyWriteOnly	LITERAL1
ResponseInvalidInterface	LITERAL1
ResponseInvalidInterfaceCommand	LITERAL1
ResponseInvalidInterfaceProperty	LITERAL1
ResponseInvalidInterfacePropertyValue	LITERAL1
ResponseInvalidPayload	LITERAL1
ResponseOK	LITERAL1
ResponsePasswordReadOnly	LITERAL1
ResponsePayloadTooLarge	LITERAL1
ResponseTryAgainLater	LITERAL1
ResponseUnknownClient	LITERAL1
ResponseUnsupportedMessage	LITERAL1
ResponseWrongPassword LITERAL1
StateClosed	LITERAL1
StateClosing	LITERAL1
StateOff	LITERAL1
StateOn	LITERAL1
StateOpen	LITERAL1
StateOpened	LITERAL1
StateOpening	LITERAL1
StatePartiallyClosed	LITERAL1
StatePartiallyOpen	LITERAL1
StateTurningOff	LITERAL1
StateTurningOn	LITERAL1
StateUnknown	LITERAL1
storedPassword	KEYWORD2
storedPasswordLength	KEYWORD2
type	KEYWORD2
TypeOnOff	LITERAL1
TypeOnOffSimple	LITERAL1
TypeOpenClose	LITERAL1
TypeOpenCloseStop	LITERAL1
TypeSensor	LITERAL1
UnitAmpere	LITERAL1
UnitAmpere2	LITERAL1
UnitBecquerel	LITERAL1
UnitBel	LITERAL1
UnitBit	LITERAL1
UnitBool	LITERAL1
UnitByte	LITERAL1
UnitCandela	LITERAL1
UnitCoulomb	LITERAL1
UnitDegree	LITERAL1
UnitDegreeCelsius	LITERAL1
unitDen	KEYWORD2
UnitEnum	LITERAL1
UnitFarad	LITERAL1
UnitGram	LITERAL1
UnitGray	LITERAL1
UnitHenry	LITERAL1
UnitJoule	LITERAL1
UnitKatal	LITERAL1
UnitKelvin	LITERAL1
UnitLumen	LITERAL1
UnitLux	LITERAL1
UnitMeter	LITERAL1
UnitMeter2	LITERAL1
UnitMeter3	LITERAL1
UnitMole	LITERAL1
UnitNewton	LITERAL1
unitNum	KEYWORD2
UnitOhm	LITERAL1
UnitOne	LITERAL1
UnitPascal	LITERAL1
UnitRadian	LITERAL1
UnitRGB	LITERAL1
UnitSecond	LITERAL1
UnitSecond2	LITERAL1
UnitSecond3	LITERAL1
UnitSiemens	LITERAL1
UnitSievert	LITERAL1
UnitTesla	LITERAL1
UnitUTF8Text	LITERAL1
UnitVolt	LITERAL1
UnitWatt	LITERAL1
UnitWeber	LITERAL1
UnitRGB	LITERAL1
value	KEYWORD2
